|-----------------------------------------------------------------------------|
|                                                                             |
|   |---------| |------------|        |-----------------------|               |
|   |.........| |............+##### |--.......................|               |
| --|.........|-|............|    # |.........................|-------|       |
| |..........................|    # |--........|-|....................|--|    |
| |........................|--    #   |........| |.......................|--| |
| |...|-|-|.|-|.......|-|..|      #   |----+---| |----|.|---|...............| |
| |...|   |.| |.......| |..|--  ############          |.|   |...............--|
| |---|   |-| |-------| |+---|  #    |--------+---------|      |..............|
|                        #      #    |...............|         |..............|
|                        #      #    |...............+#########+..............|
|            #####################   |...............|      |...............| |
|            #              #    #   |-----+------|         |--------+------| |
|  |-|    |--+----| |----|  #    #         #                         #        |
|  |.|    |.......| |....|  #    #         #     |--------|     |----+------| |
|  |.|----|.......|-|....|  #    ###########     |........|     |...........| |
||--.....................|  #              #     |........|     |...........| |
||.......................|  #       |------+--|  |.......---| |-|...........| |
||--.....................|  #       |.........| |...........| |.......|-|...| |
|  |.|-|...........|-|...+##########+.........|-|...........|-|.......| |...| |
|  |.| |...........| |...|          |...................|.|-|.|----|.|  |---| |
|  |-| |-----------| |---|          |-------------------|.| |.|    |.|        |
|                                                       |-| |-|    |-|        |
|-----------------------------------------------------------------------------|
