|-----------------------------------------------------------------------------|
|                                                                             |
| |--| |----| |--------------|        |----| |----------------|               |
| |..| |....| |..............+#####   |....| |................|               |
| |..|-|....|-|..............|    #   |....|-|................|-------|       |
| |..........................|    #   |.|-|.|-|.......................|--|    |
| |..........................|    #   |.| |.| |..........................|    |
| |.....|----|.......|-|.....|    #   |-| |+| |-----------|.|............|    |
| |.....|    |.......| |.....|  ############              |.|............|-|--|
| |-|.|-|    |-------| |-+---|  #    |--| |---+------|    |-|  |..............|
|   |...|                #      #    |..| |..........|         |..............|
|   |---|                #      #    |..|-|..........+#########+..............|
|     |-|    #####################   |...............|      |...............| |
|     |.|    #              #    #   |-----+------|         |--------+------| |
|  |--|.|----+--| |------|  #    #         #                         #        |
|  |-|..........| |......|  #    #         #     |--------|   |------+------| |
|    |..........|-|......|  #    ###########     |........|   |.............| |
|  --|...................|  #              #     |........|   |--...........| |
|  |.....................|  #          |---+-----|.......-------|...........| |
|  |.....................|  #          |...................|-|..............| |
|  |.....................+##########+|-|...................| |..............| |
|  |.....................|          |...................---| |-|.|----------| |
|  |---------------------|          |-------------------       |.|            |
|                                                              |-|            |
|-----------------------------------------------------------------------------|
